###################################################################################
#                                                                                 #
#                                                                                 #
#                                                            #############        #
#                                                            #     *     #        #
#                                                            #           #      * #
#                          ~                                 #           #        #
#                                                                        #        #
#                                                            #           #        #
#                                                            #           #        #
#                                                            #           #        #
#                                                            #           #        #
#                            ^                               #############        #
#              ^                                                                  #
#                                                                                 #
#                                                                                 #
#    ########                                                                     #
#    #      #                                                                     #
#    # *                                                                          #
#    #      #                                                                     #
#    ########                                                                     #
#                                                                                 #
#                                                                                 #
#                                                                                 #
#                                                                                 #
#                                                                                 #
#                                                                                 #
#                                                                                 #
#                                                                                 #
#                                                                                 #
#                                                                                 #
###################################################################################