##############################################################################################################################################################################
#    ################################################################################################                                                                        #
#    #                        #             #              #             #                          #                                                                        #
#    #                        #             #              #             #                          #                                                                        #
#    #                        #             #              #             #                          #                                                                        #
#    #                        #             ################             #                          #                                                                        #
#    #                                                                                              #                                                                        #
#    #                        #                                          #                          #                                                                        #
#    #                        #                                          #                          #                                                                        #
#    #                        #                ##      ##                #                          #                                                                        #
#    #                        #                ##      ##                #                          #                                                                        #
#    ##########################                                          ############################                                                                        #
#    #                        #                                          #                          #                                                                        #
#    #                        #                ##      ##                #                          #                                                                        #
#    #                        #                ##      ##                #                          #                                                                        #
#    #                        #                                          #                          #                                                                        #
#    #                                         ##      ##                                           #                                                                        #
#    #                        #                ##      ##                #                          #                                                                        #
#    #                        #                                          #                          #                                                                        #
#    #                        #                                          #                          #                                                                        #
#    ############################################      ##############################################                                                                        #
#                                                                                                                                                                            #
#                                                                                                                                                                            #
#                                                                                                                                                                            #
#                                                                                                                                                                            #
#      #############                                                                 #############                                                                           #
#      #     *     #                                                                 #     *     #                                                                           #
#      #           #                                                                 #           #                                                                         * #
#      #           #                                                                 #           #                                                                           #
#      #   ~                                                                                     #                                                                           #
#      #           #                                                                 #           #                                                                           #
#      #           #                                                           &     #           #                                                                           #
#      #           #                                                                 #           #                                                                           #
#      #           #                                                                 #           #                                                                           #
#      #############         ^                                                  @    #############                                                                           #
#              ^                                                                                                                                                             #
#                                                                                    #############                                                                           #
#                                                                                    #           #                                                                           #
#      ########                                                                      #           #                                                                           #
#      #      #                                                                                  #                                                                           #
#      # *                                                                           #           #                                                                           #
#      #      #                                                                      #           #                                                                           #
#      ########                                                                      #############                                                                           #
#                                                                                                                                                                            #
#      #############                                                                 #############                                                                           #
#      #           #                                                                 #           #                                                                           #
#      #           #                                                                 #           #                                                                           #
#      #                                                                             #           #                                                                           #
#      #           #                                                                             #                                                                           #
#      #           #                                                                 #           #                                                                           #
#      #           #                                                                 #           #                                                                           #
#      #############                                                                 #############                                                                           #
#                                                                                                                                                                            #
#      #############                                                                 #############                                                                           #
#      #           #                                                                 #           #                                                                           #
#      #           #                                                                 #           #                                                                           #
#      #           #                                                                 #           #                                                                           #
#      #                                                                                         #                                                                           #
#      #           #                                                                 #           #                                                                           #
#      #           #                                                                 #           #                                                                           #
#      #############                                                                 #############                                                                           #
#                                                                                                                                                                            #
#                                                                                                                                                                            #
#                                                                                                                                                                            #
##############################################################################################################################################################################